Håkon Duås Bjerkestrand --> August Reitan Bøgseth
Shiza Ahmad --> Gabriel Kjølsrud Bøhn
Håvard Johannes Versto Daleng --> Aksel Estensen
Josefine Arntsen --> Marius Strand Fredriksen
Jon Bergland --> Kristoffer Thorsdal Fredriksen
Nathalie Graidy Andreassen --> Henrik André Gaustad
Vetle Traran Bjørnøy --> Magnus Grini
August Reitan Bøgseth --> Sverre Grønhaug Halvorsen
Steven Ha --> Edvard Granheim Harbo
Sverre Grønhaug Halvorsen --> Hong An Ho
Vitaliy Konstantinovich Bravikov --> Erik August Christensen Hoff
Markus Evald Dalbakk --> Jonathan Skomsøy Hübertz
Jonas Grønskag Johansen --> Lida Victoria Johnsen
Mikael Stray Frøyshov --> Markus Hysing Jøssund
Brahim Helland --> Kristiane Skogvang Kolshus
Tam Minh Le --> Markus Stuevold Madsbakken
Henrik Utistog Hausberg --> Andreas Madsen
Charlotte Adele Heidenstrøm Corapi --> Aryan Malekian
Johan Martin Arntsen --> Kevin Dennis Mazali
Jon Erik Klakken --> Ole-Thomas Sundvoll Moe
Aryan Malekian --> Anders Noel Lothe Morille
Vetle Solheim Hodne --> Conrad Tinius Osvik
Sofia Simone Håbrekke --> Jonas Reiher
Kevin Dennis Mazali --> Snorre Stemshaug Roe
Maamoun Adnan Hmaidoush --> Carine Margrethe Rondeel
Vahideh Rezaei --> Jon Martinus Rødtang
Embret Olav Rasmussen Roås --> Ramtin Forouzandehjoo Samavat
Hans Lawrence Pettersen --> Erik Sandvik
Kristoffer Thorsdal Fredriksen --> Kaamya Shinde
Amund Mørk --> Eskild Smestu
Bård Helge Hansen --> Garv Sood
Jonas Reiher --> Sigurd Spook
Sigrid Hoel --> Eva Stamatovska
Anne Cecilie Skår Nilsen --> Henrik Sund
Markus Nikolai Hagen --> Sara Taghypour
Jeffrey Yaw Annor Tabiri --> Nikolai Tandberg
Jakob Huuse --> Jeppe Evensen Thy
Joakim Skogø Langvand --> Kenny Bach Phong Tran
Jonathan Skomsøy Hübertz --> Tini Tran
Kaamya Shinde --> Nicklas Persia Tufteland
Henrik André Gaustad --> Victor Udnæs
Vetle Pettersen --> Vilde Min Vikan
Eskild Smestu --> Melissa Visnjic
Theo Holmvik --> Marcus Westum
Erik August Christensen Hoff --> Alper Yarenbasi